  111
1110111
1010001
1000N01
1111111
